NO srcs/texture/planks.xpm
SO srcs/texture/planks.xpm
WE srcs/texture/planks.xpm
EA srcs/texture/planks.xpm

F 74,111,40
C 81, 176, 219

1111111111111111111111111
1000000000110000000000001
10110000011100000S0000001
1001000000000000000000001
1111111110110000011100001
1000000000110000011101111
1111011111111101110000001
1111011111111101110101001
1100000011010101110000001
1000000000000101110101011
1000000000000001110101011
1100000111010101110000001
11110111 11111101110101001
11111111 11111101110101001
11111111 11111111111111111
