SO srcs/texture/wall.xpm
NO srcs/texture/floor.xpm
WE srcs/texture/north.xpm
EA srcs/texture/west.xpm

F 0,0,0
C 38,141,114

        1111111111 11111111111111
        1000000001110000000000001
        10110E0001110000011100001
        1001000000000000001000001
111111111011000001110000011100001
100000000011000001110111111111111
11110111111111011100000010001
11110111111111011101010010001
11000000110101011100000010001
10000000000000011000000100001
10000000000000001101010010001
11000001110101011111011110001
11110111 1110101 101111010001
11111111 1111111 111111111111