NO srcs/texture/north.xpm
SO srcs/texture/south.xpm
WE srcs/texture/west.xpm
EA srcs/texture/east.xpm

C 81, 176, 219
F 64, 41, 10

        11111111111 11111111111111
        10000000011100000000000011111
        1011000001110000011100001001
        1100100000000000000100000111
111111110110000011100000111000011
100000000011000001110111111111111
11110111111111011100000010001
11110111111111011101010010001
11000000110101011100000010001
100000000E0000011000000100001
10000000000000001101010010001
11000001110101011111011110001
11110111 1110101 101111010001
11111111 1111111 111111111111
